1111111
1000EC1
110P0C1
1111111