1111111111
1111111111
1111E11111
11111111P1