11111111111111
1000000E000011
1000C001000001
11100000011111
10001001111001
11111111111111
11111101110101
1
1