1111111111
1000000111
1000101111
10000P0001
1001E11111
1111111111