1111111111
1111111111
1111111111
11111111P1