

11111111111111
10000001000001
10000001000001
11111111011111
10000001111001
11111111111111







