1111111111111111
1111c00c11111111
1000000000111111
1000100000111111
1111111111111111