1111111111
100000011
1000101111
10000P0001
1001E11111
1111111111