111111111
110011011
1100P0001
111111111