1111111111
10001
1111111111
1111111111