1111111
1000EC1
1100PC1
1111111